16 15
################
################
################
#..P.####......#
################
################
################
################
#...E..#.......#
#......#...E...#
################
################
################
################
RRRRRRRRRRRRRRRR