16 15
................
################
################
#..P.###########
################
################
################
################
#...E..#########
########...E...#
################
################
##...E...#######
################
RRRRRRRRRRRRRRRR